111111111111111111111111111111111111111
10001100000C0000000C000000C01000000C001
100C0100C011111C00000C00011110C000000C1
1000C00000010C10000C000C00010000C011111
111111110C010010C00000C0000100E000C0001
10000C01P001001000111111100100001111111
1C0C00010C000000C00000C0000000C000C0001
100C0000000000100C0100C00001000C000C001
1000C0C10001001C0001000000010C000C00001
111111111111111111111111111111111111111