1111111
10C00P1
1C0E001
1111111